#######################
#.....................#
#................#....#
#...o............#....#
#................#....#
#................#....#
#................#....#
#................#....#
#................#....#
#................#....#
#................#....#
#................#....#
#................#....#
#................#....#
#................#....#
#................#....#
#................#....#
#................#....#
#................#....#
#................#....#
#................#....#
#................#....#
#................#....#
#.################....#
#................#....#
################.#....#
#................#....#
#.################....#
#.................*...#
#######################